┌───┬─┬───┬─────────────┬───────┬─────┬─────────┬─────────┬─────┬─────────────┬─────┬─────────────┬─────────────────┬───────────┬─────────────┬─────────────┬───┬───────┬───────┬───────┬───────────┐ 
├─╴ │ │ ╷ │ ┌─┐ ╶─────┐ │ ╶─┐ ╶─┘ ┌─┐ │ ┌─────╴ │ ╶─┬───┐ │ ╶─┐ ╵ ╷ ┌─────┬─┐ └─┐ ╷ │ ╷ ╶─────┐ ┌─┘ ┌─┐ ╶───┐ ┌─────┘ ┌─┬─────┐ │ ┌───┬─╴ ╷ ┌─┘ ┌───────┐ ╷ ╵ ╷ └─╴ ┌─┐ │ ┌─╴ ╷ │ ╷ ┌─╴ │ ╶─┐ ╶─┬─┐ │ 
│ ┌─┘ ╵ │ ╵ ╵ └─┬───┐ │ └─┐ ├─────┘ │ ╵ │ ╷ ┌───┴─┐ └─┐ │ ╵ ┌─┴───┘ │ ┌─┐ │ └─╴ ╵ ├─┘ ├─────┐ └─┘ ┌─┘ └─┬─┐ │ │ ╶───┬─┘ │ ┌─┐ │ │ └─╴ │ ╶─┴─┘ ┌─┴─┐ ╶─┬─┘ ├───┼───┬─┘ │ └─┤ ╶─┴─┤ │ └─┬─┴─╴ ├─┐ │ ╵ │ 
│ │ ╶───┴─┬─────┤ ╷ │ ├─╴ │ └─┬───╴ └─┬─┤ └─┘ ╶─┐ └─┐ ╵ ├───┤ ┌─┬─╴ │ ╵ │ └─┐ ┌───┘ ┌─┤ ╶─┐ └───┬─┘ ╶─┐ ╵ │ └─┴───╴ │ ┌─┘ │ │ │ └───╴ ├───────┘ ╷ └─╴ │ ┌─┘ ╷ ╵ ╷ └─┐ └─┐ └───┐ ╵ └─┐ ╵ ┌───┤ │ └─┐ │ 
│ │ ┌─────┘ ┌─┐ ╵ │ │ └───┴─┐ │ ┌───╴ │ ├─────┬─┘ ╷ ├─┐ │ ╷ │ │ ╵ ╶─┼─╴ ├─╴ ├─┘ ┌───┘ ├─╴ ├─╴ ┌─┘ ┌─┐ └─┐ └─────────┤ │ ┌─┘ │ └─┬─────┘ ╷ ╶─┬───┴─╴ ┌─┘ │ ╶─┴───┴─┐ ╵ ┌─┴───┐ └───┐ └───┘ ╷ ╵ └─┐ │ │ 
│ └─┘ ┌─────┤ └───┤ │ ╶─┬─╴ │ │ ├───┐ ╵ │ ╷ ╷ │ ┌─┘ ╵ │ └─┘ │ │ ┌───┘ ┌─┘ ┌─┘ ┌─┴─╴ ╷ │ ╶─┤ ╶─┘ ┌─┘ └─┐ └─┬─┬─────╴ ╵ │ ╵ ╷ └─┐ ╵ ┌─┬───┴─┐ └───┬───┘ ┌─┘ ╶─┬───╴ ├─╴ │ ╷ ╶─┴───┐ └───────┼───╴ │ └─┤ 
├─────┤ ╷ ┌─┘ ╷ ╶─┘ ├─╴ │ ╷ │ │ ╵ ╷ └─┬─┘ │ ├─┘ │ ┌───┴─┬─╴ │ │ │ ┌───┤ ╷ │ ┌─┴─╴ ┌─┴─┴─┐ ├─────┴─┐ ╷ └─┐ │ │ ┌─┬─────┴───┴─┐ └─┬─┘ ╵ ┌─╴ └─┬─╴ │ ╶───┤ ╶─┬─┘ ┌───┴───┘ ├───┐ ╷ └───┬───┐ │ ┌───┴─┐ │ 
│ ┌───┘ │ ╵ ┌─┼─────┘ ┌─┤ │ │ └─┐ └─┐ ╵ ┌─┘ │ ╶─┴─┘ ┌─┐ │ ╶─┤ └─┘ │ ┌─┘ ├─┘ │ ╷ ┌─┘ ╷ ╶─┤ └─┐ ╷ ╷ ╵ │ ┌─┘ │ ╵ ╵ │ ┌─────┐ ╷ └─┐ └─────┘ ╷ ┌─┘ ┌─┴───┐ ├─╴ │ ╶─┤ ╶───────┤ ┌─┘ ├───╴ ╵ ╷ │ │ ╵ ┌─╴ │ │ 
│ │ ┌───┼───┘ │ ╶─┬───┘ │ └─┴─┐ └─┐ └─┬─┤ ╶─┴─┬─────┘ │ └─┐ └───┬─┘ │ ╶─┘ ┌─┘ └─┘ ┌─┴─╴ ├─╴ │ │ └───┴─┤ ╶─┴─┐ ┌─┘ │ ╷ ╷ │ ├─╴ ├─────────┘ │ ┌─┘ ┌─╴ │ └───┤ ╷ └───────┐ ╵ │ ╷ ├───────┤ │ │ ┌─┴───┤ │ 
│ │ ╵ ╷ ├─╴ ┌─┴─╴ │ ┌─╴ └─┐ ╶─┴─┐ ├─┐ ╵ ├─┐ ╷ ├───┬─╴ ├─╴ ├───┐ └─┐ └─────┴───────┤ ╶───┘ ┌─┴─┤ ┌───╴ ├───┐ └─┘ ┌─┴─┘ │ │ └─┬─┘ ┌─────────┤ ╵ ┌─┤ ╶─┴───┐ └─┴─┐ ╶─┐ ╷ └─┐ │ └─┤ ╶───┐ │ │ └─┘ ┌─┐ ╵ │ 
│ └───┤ │ ╶─┘ ┌───┘ ├─────┴─┐ ┌─┘ │ └─╴ │ │ │ ╵ ╷ │ ╷ │ ╷ └─╴ └─┐ │ ┌─────────┬─┐ └─┐ ┌───┘ ╷ ├─┘ ┌─┐ │ ╶─┴─────┘ ╷ ╶─┴─┴─┐ │ ╶─┘ ┌─────┐ └─┬─┘ └─────┐ └───┐ │ ┌─┘ │ ┌─┘ ├─┐ └───╴ │ │ ├───┬─┘ └─┐ │ 
│ ╷ ┌─┘ │ ╶───┴─┐ ┌─┘ ┌───╴ │ ╵ ┌─┘ ╶─┬─┘ │ ├───┤ ╵ │ │ ├─╴ ┌───┤ ╵ │ ╶─┬───┐ ╵ └─┐ │ └───╴ │ ╵ ┌─┘ ╵ └───┬───┐ ┌─┴─────┐ │ └─────┘ ╶─┐ └─╴ ╵ ╷ ┌─────┴───╴ │ │ │ ╶─┴─┤ ╶─┘ ├─┬─────┤ │ ╵ ╷ └───╴ │ │ 
│ │ │ ┌─┴─────╴ │ │ ╶─┴───┐ │ ╶─┴─┬─┐ ╵ ╷ │ │ ╶─┼───┘ │ │ ┌─┘ ╷ └─┬─┴─╴ ├─╴ ├───╴ │ └─────┬─┴─╴ ├───┬───╴ ╵ ╷ ├─┘ ┌───┐ │ └─────┬───┐ └───┬───┼─┘ ┌─────────┘ ├─┴───╴ └───┐ │ │ ╶─┐ │ ├───┼─╴ ┌───┘ │ 
│ └─┤ ├─────┐ ╶─┘ └─┬─┬─╴ │ ├─┬─╴ │ ├───┤ │ │ ╷ ╵ ╶───┤ │ │ ╶─┤ ╷ │ ╷ ┌─┘ ╶─┤ ╶─┬─┴─┬───╴ │ ┌───┘ ╷ └─────┬─┘ ╵ ┌─┘ ╶─┘ ╵ ┌───┬─┘ ╷ └─────┘ ╷ ╵ ╷ │ ╶─┬───────┤ ╶─┬─╴ ┌───┤ ╵ └─┐ │ │ └─┐ ╵ ╶─┤ ┌───┤ 
│ ╷ │ ╵ ┌─╴ │ ┌───┐ ╵ │ ┌─┤ │ │ ╶─┤ ╵ ╷ ╵ │ ├─┴───┬───┘ │ ├─┐ │ └─┘ │ │ ┌─╴ ├─╴ └─╴ │ ┌─┬─┘ │ ┌───┴─────┐ └─────┴─────────┘ ╷ │ ┌─┴───┬─────┴───┘ ├─┐ │ ╶─────┘ ╷ └───┘ ╷ └───╴ │ │ └─┐ └─┬─╴ │ │ ╶─┤ 
├─┘ └─┬─┘ ┌─┴─┘ ╷ ├───┘ │ │ │ └─┐ │ ┌─┼───┘ │ ┌─┐ │ ╶─┬─┘ ╵ │ ├─────┤ └─┤ ┌─┘ ┌─────┘ │ │ ┌─┤ │ ╶─┬─┬─╴ └───────┬───────┬───┤ │ │ ╷ ╶─┘ ┌─────┬───┤ │ │ ╶─┬─────┤ ┌─────┼───┬───┘ ├─╴ │ ╷ └───┘ │ ╷ │ 
│ ┌───┤ ┌─┘ ╶─┬─┤ ╵ ┌─┬─┘ ╵ ├─╴ │ │ │ │ ╷ ┌─┘ │ │ ├─╴ │ ╶─┬─┘ ├───╴ └─┐ │ ╵ ╶─┤ ╶─┬─┬─┘ ╵ ╵ │ └─┐ │ │ ╶───┬─────┘ ╷ ┌─┐ └─┐ │ ╵ │ └─┬───┘ ┌─╴ │ ╷ │ │ └───┘ ┌─╴ │ └─┐ ╷ │ ┌─┘ ┌─┬─┘ ┌─┘ ├─────┬─┴─┘ │ 
│ ╵ ╷ │ └───╴ │ └───┘ │ ┌───┘ ╶─┤ │ ╵ │ │ │ ┌─┤ ╵ │ ┌─┴─╴ │ ┌─┘ ┌─╴ ┌─┘ ├─────┴─╴ │ ╵ ┌─────┴─╴ │ │ ├───┐ │ ┌─────┤ │ └─┐ ╵ └───┴─┐ └─┬─╴ │ ┌─┘ │ │ └───────┤ ┌─┴─╴ ╵ │ ╵ │ ╶─┤ │ ┌─┘ ┌─┘ ╷ ╶─┘ ╷ ╶─┤ 
│ ╶─┤ └─┬─────┤ ╷ ╶─┐ │ │ ┌───┐ │ └───┤ └─┤ │ ╵ ┌─┘ │ ┌───┘ │ ╷ └───┤ ╶─┤ ╶───┬───┴───┤ ╶───┬───┘ ╵ │ ╷ │ ╵ │ ┌─╴ │ │ ╷ ╵ ┌─────┐ ├─┐ ╵ ┌─┘ │ ┌─┘ └─┐ ╶─┐ ╶─┤ └─┐ ╶─┬─┴───┴─┐ │ │ │ ╶─┴───┴─┐ ┌─┴─┐ │ 
├─┐ └─┐ ╵ ╷ ┌─┘ ├─┐ └─┘ │ ╵ ╷ │ └───╴ └─╴ │ │ ╶─┘ ┌─┤ │ ┌───┤ ├─┬─╴ └─┐ └───┐ │ ┌─╴ ╷ ├───╴ │ ┌───┐ │ │ │ ╶─┘ ├───┤ └─┴─┐ │ ┌─┐ │ ╵ └───┤ ╶─┤ └─┬─╴ └─┐ └─┐ ├─╴ │ ┌─┘ ┌───┐ ╵ │ │ └─────┬─┐ │ ├─╴ │ │ 
│ ╵ ┌─┴─┬─┘ │ ┌─┘ └─┬───┴───┘ ├───┬───┬─╴ │ └───┬─┘ │ │ │ ┌─┘ │ │ ╶───┴─┐ ╷ │ └─┘ ┌─┘ │ ╶─┬─┘ │ ╷ │ │ │ └─┐ ┌─┘ ╷ └───╴ ├─┘ │ │ └───┬─┐ ├─╴ │ ╷ └───┐ └─┐ │ │ ╶─┴─┘ ┌─┘ ╷ └───┤ └─────┐ │ │ │ ╵ ╷ │ │ 
├───┤ ╷ │ ╷ │ │ ╶─┐ └─┐ ┌─────┤ ╷ │ ╷ ├───┤ ┌─╴ │ ╷ ╵ │ │ ╵ ┌─┘ └─┬───┐ │ └─┴─────┘ ┌─┴─┐ ├───┘ │ └─┤ ├─┐ └─┤ ╶─┴───────┘ ┌─┘ └─┬─╴ │ ╵ │ ┌─┴─┴───╴ ├─╴ └─┘ ├─────┐ │ ╶─┼─╴ ╷ └─────╴ │ │ ╵ │ ┌─┴─┘ │ 
│ ╷ ╵ │ │ ├─┘ │ ╷ └─┐ │ │ ╶─┐ ╵ │ │ │ ╵ ╷ ├─┘ ┌─┘ ├───┘ │ ╶─┴─╴ ╷ │ ╷ ╵ ├───────┬───┘ ╷ │ │ ┌───┴─┐ ╵ │ └─┐ │ ╶───┬───┐ ╶─┤ ╷ ┌─┘ ╷ ├───┘ │ ╷ ┌─╴ ┌─┴───────┘ ┌─┐ │ └───┘ ┌─┴───┐ ┌───┤ └─┐ └─┤ ┌─╴ │ 
│ └─┬─┘ ╵ │ ╶─┴─┴─╴ │ └─┤ ╷ └─┬─┘ │ └─┬─┘ │ ╶─┴─┐ │ ╶───┴─┬─────┘ │ ├─╴ │ ╶─┐ ╷ │ ╷ ┌─┤ ╵ │ ╵ ┌─┐ └───┤ ╶─┤ └─┬─╴ │ ╷ └─┐ └─┘ │ ╶─┤ │ ╶───┴─┘ │ ┌─┘ ┌─┬───────┘ │ ├─────┐ │ ╶─┐ └─┘ ╷ └─╴ ├─╴ │ └─┐ │ 
│ ╷ └─────┴─────┬───┴─┐ └─┤ ╷ │ ┌─┘ ╷ └─┐ ├───┐ └─┴───┬─╴ ├───┐ ┌─┘ │ ╶─┴─┬─┘ │ └─┤ │ └─┐ └───┤ └─┬─╴ ├─╴ ├─╴ ├───┘ ├─┐ │ ┌───┤ ╷ └─┴─┐ ┌───┬─┘ │ ┌─┘ │ ╶─┬─┬─╴ │ ╵ ┌─┐ ├─┴─╴ ├─────┼─────┤ ┌─┘ ╷ └─┤ 
│ └─┬─────╴ ┌─┐ └─┬─╴ └─┐ │ │ │ └─┐ └─┐ │ ╵ ╷ └───┐ ╷ ╵ ┌─┘ ╷ └─┘ ┌─┴───┐ │ ┌─┴─╴ ╵ │ ╷ └─┬─╴ ├─╴ │ ┌─┤ ╶─┤ ╶─┘ ┌───┘ │ ├─┘ ╷ └─┤ ╷ ╷ │ │ ╷ └─┬─┘ │ ┌─┴─╴ ╵ │ ╷ ├───┘ │ │ ┌───┤ ╶─┐ ╵ ┌─╴ │ └───┴─┐ │ 
├───┘ ┌─────┘ └─┐ ╵ ┌─╴ │ ├─┘ ├─┐ │ ┌─┘ ├───┼───┐ │ └─┬─┘ ╶─┼─────┼───╴ │ │ └───────┤ │ ┌─┘ ┌─┘ ╷ │ │ ╵ ╷ └─┬───┴─╴ ╷ │ ╵ ┌─┴─┐ ├─┘ │ │ │ └─┐ ╵ ┌─┤ ╵ ┌─────┘ │ │ ╶─┐ ╵ │ │ ╶─┘ ╷ ├───┘ ┌─┴─────┐ ╵ │ 
│ ╶─┬─┘ ╶─┐ ╶───┴───┘ ┌─┤ ╵ ┌─┤ ╵ │ │ ┌─┘ ╶─┘ ╷ ╵ ├─╴ └───┐ │ ╶─┐ ╵ ┌─╴ │ └─┬───┬─╴ ├─┘ │ ┌─┘ ╶─┼─┘ │ ┌─┘ ╷ ╵ ┌─────┤ ├─┬─┘ ╶─┤ │ ╶─┤ │ ├─╴ ├───┘ ╵ ┌─┘ ┌─┬───┤ └─┐ ├───┘ └─┬───┤ │ ╶─┬─┘ ╶─┬─┐ └─┐ │ 
│ ╷ │ ┌───┼───┐ ╶─────┘ ├───┘ │ ╶─┴─┤ │ ┌───┬─┴───┼───┬─╴ │ │ ╷ ├───┘ ┌─┴─┐ ╵ ╷ │ ┌─┘ ╶─┘ │ ╶─┐ │ ┌─┘ │ ┌─┴─┬─┘ ╶───┤ │ │ ╶─┐ │ └─┐ └─┘ │ ┌─┴───┐ ╶─┤ ┌─┘ ╵ ╷ ├─╴ │ └─────╴ │ ╷ ╵ ├─┐ └───╴ │ │ ┌─┘ │ 
├─┘ ├─┘ ╷ │ ╷ └───────┐ └─╴ ╷ └─┬─┐ ╵ │ │ ╶─┘ ╷ ╷ ╵ ╷ │ ┌─┘ └─┤ └─┬───┘ ╷ └─┬─┘ │ ├─────┐ └─┬─┘ │ │ ┌─┘ ├─╴ │ ┌───┐ ╵ ╵ └─┐ │ └─╴ │ ╶─┬─┘ │ ┌─┐ └─┬─┘ │ ╶───┤ ╵ ┌─┼─────┬───┘ └─┬─┘ └─────┬─┘ ╵ │ ╶─┤ 
│ ╷ │ ╶─┤ ╵ └───┬───╴ ├─────┼─╴ │ └───┤ └───┐ │ └─┬─┤ │ └───┐ │ ╷ ╵ ┌───┴─┐ │ ┌─┘ │ ┌─╴ ├─╴ ╵ ╷ │ └─┤ ┌─┘ ╶─┤ └─┐ └─┬─────┤ └───┬─┼─╴ │ ┌─┘ │ └─┐ │ ╶─┴─────┴─┐ │ ╵ ╷ ┌─┘ ┌─┬─╴ ├───────┐ ╵ ╶─┬─┴─┐ │ 
│ ├─┴─╴ ├───┐ ┌─┘ ┌───┘ ┌───┘ ┌─┘ ┌───┴───┐ └─┴─╴ │ ╵ ├─┬─╴ │ └─┤ ╶─┤ ┌───┘ │ │ ╷ │ │ ╶─┤ ┌───┤ └─┐ │ │ ┌─╴ ├─╴ ├─╴ │ ╶─┐ └───╴ │ ╵ ╶─┤ ╵ ╶─┼─╴ │ └─┐ ┌─┬───╴ │ └─┬─┘ │ ┌─┘ │ ╶─┘ ┌───┐ ├───┐ └─╴ │ │ 
│ ╵ ╶───┤ ╷ └─┘ ┌─┘ ╶─┐ │ ╶───┤ ┌─┘ ┌─┐ ╷ └─┬─────┤ ┌─┤ ╵ ╶─┴─╴ ├─╴ ╵ │ ╶───┘ ╵ ├─┘ ├─┐ └─┤ ╷ └───┤ │ │ │ ╶─┘ ╶─┘ ╷ └─┐ ├─────┬─┘ ┌───┴───┐ ╵ ┌─┴─╴ │ │ │ ╶─┬─┴─┐ │ ╶─┤ ╵ ╷ ├───┬─┘ ╷ │ ╵ ╷ └─┬───┘ │ 
│ ╶─┬───┘ ├───┬─┘ ┌─╴ ├─┴───┐ │ ╵ ┌─┘ │ ├───┘ ╷ ╶─┘ │ │ ┌───────┴─────┴─────────┤ ┌─┘ ├─╴ │ └─┬─╴ │ │ │ └───┬─┬───┴─┐ │ │ ┌─┐ │ ╶─┤ ┌─┬─╴ ├─╴ │ ┌───┤ ╵ └─┐ │ ╷ │ └─┐ └─┬─┘ │ ╷ └─╴ │ └─┬─┼─╴ │ ┌───┤ 
├─┐ │ ┌───┘ ╷ ├───┤ ╶─┤ ╷ ╶─┘ │ ┌─┴─╴ │ │ ┌───┼─────┤ ╵ │ ┌─────┬─────┬───────╴ │ │ ╶─┘ ┌─┤ ╷ └─┐ ╵ │ ├─┬─╴ ╵ │ ┌─┐ └─┘ │ ╵ │ └─╴ │ │ │ ┌─┘ ╶─┤ └─┐ ╵ ┌───┘ │ │ ├─╴ ╵ ┌─┘ ┌─┘ └─────┴─┐ ╵ │ ╶─┤ └─╴ │ 
│ ╵ │ ╵ ╶───┤ ╵ ╷ ├─╴ │ └─┬───┘ ╵ ┌───┘ │ │ ┌─┘ ╶─┐ ╵ ╶─┤ └───┐ ╵ ╷ ╷ │ ┌───────┘ │ ┌───┘ ╵ └─┐ └─┬─┘ │ │ ┌─┬─┘ │ └─┬───┴───┼─────┘ │ ╵ │ ┌───┴─╴ │ ╶─┤ ┌───┘ │ ├─────┤ ┌─┴─────┬───╴ ├───┴─┐ └───┐ │ 
├───┴─┬───┐ └─┬─┤ │ ╶─┴─┐ ├─────┐ │ ┌───┘ │ ╵ ┌─┬─┴─────┴───╴ │ ┌─┤ └─┘ ├─╴ ┌─────┤ └─┬───┐ ┌─┴─┐ │ ╶─┤ ╵ │ │ ╶─┘ ╷ │ ╷ ┌─┐ │ ╶─┬───┤ ┌─┴─┘ ┌───┬─┴─┐ │ ╵ ┌─┬─┘ │ ┌─┐ ╵ ├─╴ ┌─┐ │ ┌─╴ │ ┌─┐ │ ╶───┘ │ 
│ ┌─╴ ╵ ╷ └─┐ ╵ │ ├───╴ │ ╵ ┌─╴ ├─┘ │ ┌───┤ ╶─┘ │ ╶─┬───┬───┬─┤ ╵ ├─────┘ ┌─┴─┐ ┌─┴─╴ │ ╷ └─┘ ╷ ╵ │ ╷ └─┐ │ └─────┤ │ │ │ │ └─╴ │ ╷ │ └─┐ ╶─┤ ╶─┘ ╷ │ └───┘ │ ╶─┤ │ └───┘ ┌─┘ │ │ └───┘ ╵ │ └───────┤ 
│ └───┬─┴─╴ └───┘ │ ╷ ┌─┴───┤ ┌─┘ ╶─┤ │ ╷ └───╴ └─┐ ╵ ╷ │ ╷ ╵ └─┐ │ ╷ ┌───┘ ╷ ╵ │ ┌───┘ ├───┬─┴───┴─┴─╴ │ ╵ ┌─╴ ┌─┘ ├─┘ │ └─────┼─┘ └─┐ │ ╷ ├─────┘ └─┬─┬─╴ ├─╴ │ │ ┌─────┘ ╶─┤ └───────┐ └───┐ ┌─┐ │ 
│ ┌─╴ ├─────┬─────┤ └─┤ ╷ ╷ │ └─┬─╴ │ └─┤ ╶─────┬─┴───┤ │ ├─────┤ └─┘ │ ╶───┴───┘ │ ╷ ┌─┴─╴ │ ┌─╴ ┌───┬─┴───┤ ╶─┤ ┌─┘ ┌─┘ ┌───┐ ╵ ┌─╴ │ └─┘ │ ╶───┬─┐ ╵ │ ╶─┤ ╶─┘ │ └─────┬─╴ └─────┬─╴ ├─────┤ │ │ │ 
│ │ ╶─┘ ╶─┐ │ ╶─┬─┘ ╷ ╵ │ │ ├─┐ ╵ ╷ ├─╴ ├─────╴ │ ╶─┐ ╵ │ │ ┌─┐ └─────┤ ╶───┬─────┴─┘ │ ╷ ╶─┤ │ ┌─┘ ┌─┘ ┌─╴ ├─╴ │ ╵ ┌─┴─╴ │ ╷ ├───┘ ╶─┴─────┴───╴ │ └─┐ └─┐ ├─────┤ ╶───┐ │ ╷ ┌─────┘ ┌─┘ ┌─╴ │ │ ╵ │ 
│ └─┬─┬───┘ │ ╷ ╵ ╶─┴───┤ │ ╵ └───┤ │ ┌─┴───────┴─┐ ├───┘ ╵ ╵ └─┬───╴ └───┐ │ ╶───┬─┬─┘ ├─┐ ╵ │ └─┐ │ ╶─┤ ╷ │ ╶─┴─┬─┘ ┌─┐ │ │ └───────┬───────────┤ ╶─┴─╴ │ └─┐ ╷ └─┬─╴ │ │ ├─┘ ┌─────┴─╴ │ ┌─┘ └───┤ 
├─╴ │ │ ╶───┴─┴─┬─┬───╴ │ ├───╴ ┌─┘ │ └─┐ ╶─┬─┬─╴ │ └─┬───┬─────┤ ╶─┐ ┌───┘ │ ╶─┐ │ ╵ ┌─┘ └───┴─┐ │ └─╴ │ └─┴─┬─╴ └─╴ │ ╵ │ └───┬───╴ │ ┌───────┐ └─────┐ ├─┐ ├─┘ ╷ │ ┌─┘ │ ╵ ╶─┴─╴ ┌─────┤ ├─────┐ │ 
│ ┌─┘ └─┬─────┐ │ │ ╶─┬─┤ └─────┘ ╶─┴─┐ └─╴ │ │ ╶─┼─╴ │ ╷ │ ╶─┐ └─┐ ├─┘ ┌───┴───┤ └─┐ │ ╶─────┐ │ │ ┌───┴───┐ ╵ ┌─────┴─┬─┴─╴ ┌─┘ ┌───┘ ├───┐ ┌─┴─────┐ │ ╵ │ │ ╷ ├─┘ │ ╶─┤ ┌───────┤ ╶─┐ │ │ ┌─╴ │ │ 
│ ╵ ┌─┐ └─╴ ╷ │ │ └─┐ ╵ └─────┬───────┴─────┤ └─┐ │ ┌─┘ │ └─╴ ├─┐ ╵ │ ╶─┴─┐ ╶─┐ └─╴ │ ├─────┬─┘ │ │ │ ┌───┐ └───┤ ┌─┬─╴ │ ┌─┬─┘ ┌─┘ ┌───┘ ╷ ╵ │ ┌─┬─╴ │ │ ┌─┘ │ │ │ ╶─┴─┐ └─┘ ╶─┬─┐ └───┤ ╵ ╵ │ ╶─┤ │ 
├─┬─┘ └───┐ ├─┘ │ ╶─┴─┐ ┌─────┤ ╶─┬───┬───┐ ╵ ╷ │ │ └─┐ └─────┤ └─╴ ├───╴ │ ╷ ├───┬─┘ │ ╶─┐ ╵ ┌─┘ ├─┘ │ ╷ └───┐ ╵ │ │ ╶─┤ ╵ │ ╶─┤ ╶─┘ ┌───┴───┘ │ ╵ ╶─┘ │ │ ┌─┘ └─┘ ┌───┤ ┌───┐ ╵ └───┐ └───┬─┴─┐ │ │ 
│ │ ╷ ┌───┘ │ ┌─┘ ╶─┐ ╵ │ ╶─┐ └─┐ ╵ ╷ └─╴ └─┬─┘ │ └─╴ │ ┌───╴ ├─────┘ ┌───┴─┤ ├─╴ │ ╶─┼─╴ │ ┌─┘ ┌─┘ ┌─┘ └─┐ ╷ └─┬─┘ ├─╴ └─┐ └─┐ └─┬─╴ │ ╶─┬───┬─┴───┬───┤ │ ├───┐ ┌─┘ ╷ └─┤ ╷ │ ┌─────┼───╴ │ ╷ ╵ │ │ 
│ ╵ │ ╵ ╶───┤ └─────┴───┴─╴ │ ╶─┴───┴─────╴ │ ╶─┴─────┘ │ ╶───┘ ╶─────┘ ┌─╴ ╵ │ ╶─┴─╴ ╵ ┌─┘ │ ╶─┘ ╶─┴─────┘ ├─╴ ╵ ╷ │ ╶───┴─╴ └─┐ ╵ ╶─┴─┐ ╵ ╷ ╵ ╶─┐ ╵ ╷ └─┘ ╵ ╷ └─┘ ┌─┴─╴ ╵ │ └─┘ ┌─╴ ╵ ┌───┘ └───┘ │ 
└───┴───────┴───────────────┴───────────────┴───────────┴───────────────┴─────┴─────────┴───┴───────────────┴─────┴─┴───────────┴───────┴───┴─────┴───┴───────┴─────┴───────┴─────┴─────┴───────────┘ 
