┌─┬─────┬───────────┬─────────┬─────┬───────────────┬─────┬───────────┬───────────┬─────────────┬───┬─┬───────────┬───┬───────┬───┬───────────────┬───┬───┬─────────────────┬─────┬─────┬───────────┐ 
│ │ ╶─┐ └─╴ ┌─────┐ ├───┐ ╶─┐ ├─╴ ╷ │ ╷ ╶───────┬─╴ │ ╷ ╷ └───┐ ╶─────┘ ╶─┐ ╶─────┘ ╶─┐ ┌─────┐ ╵ ╷ │ ╵ ┌─╴ ┌───┐ ╵ ╷ └───╴ ╷ ╵ ╷ ├─────┐ ╷ ╶───┐ ╵ ╷ ╵ ╷ │ ┌───────┐ ┌───┐ │ ╶───┘ ╷ ╷ │ ┌─────┐ ╶─┤ 
│ └─╴ ├─────┤ ┌─╴ │ ╵ ╷ └─╴ │ │ ╶─┴─┘ ├───┬───╴ │ ╶─┼─┘ ├───┐ └─┐ ╶─┬───┬─┴───────┬───┘ │ ╶─┐ ├───┤ ├───┤ ┌─┘ ╶─┴───┼───────┴───┤ │ ┌─┐ │ ├───┐ ├───┴───┤ └─┤ ╶─┬─┐ ╵ │ ╷ │ └─┐ ┌───┤ └─┘ │ ╷ ╷ └─┐ │ 
├─────┤ ╷ ┌─┘ │ ╶─┴───┴───┬─┤ └─┐ ╶───┘ ╷ │ ┌───┴─┐ ╵ ┌─┤ ╶─┴─┐ ├─┐ ╵ ╷ │ ┌─────╴ │ ╶─┬─┴─┐ │ │ ╷ │ ╵ ╷ ╵ ├───╴ ┌─┐ │ ┌───┬─────┤ ╵ │ │ │ └─┐ │ └─┐ ╶───┴─┐ └─╴ │ └───┴─┤ ├─╴ │ │ ╶─┴─┬───┘ │ └─┐ │ │ 
│ ┌─┐ │ │ ╵ ╶─┼─────┐ ╷ ╷ │ └─┐ └───┬───┤ │ │ ┌─╴ └───┘ │ ╷ ╷ │ │ ├───┤ │ └───┐ ╶─┤ ╷ ╵ ╷ ╵ │ ╵ │ └───┼───┘ ┌─┬─┘ ╵ │ │ ╷ │ ╶─┐ └───┘ │ └─┐ ╵ └─┐ └─┐ ╷ ╶─┴─────┴───┐ ╷ │ │ ┌─┘ └─┐ ╶─┘ ┌───┴─╴ │ │ │ 
│ │ ╵ └─┴─┬───┘ ┌─╴ ├─┘ │ │ ╶─┴─┬─╴ │ ╷ │ │ │ │ ╶─┬───╴ │ │ └─┤ │ ╵ ╷ ╵ └─┬─╴ ├─┐ └─┤ ╶─┴───┴───┼───╴ ├───╴ │ ╵ ╶───┘ │ │ └─┐ │ ┌─╴ ┌─┴─┐ └─┐ ┌─┴─╴ │ └─┬───╴ ┌───┐ ╵ │ ╵ │ └───┐ └─┐ ╶─┤ ┌───┬─┘ │ │ 
│ └───┬─╴ │ ╶─┬─┤ ┌─┘ ┌─┘ └─┬─╴ │ ╶─┴─┤ ╵ │ │ ├─╴ ├─────┘ ├─┐ ╵ ├───┤ ╶─┬─┘ ┌─┘ └─┐ └─┬─────┬─╴ │ ┌───┘ ┌───┴─┬───────┤ │ ╷ │ │ └───┘ ╷ └─┐ └─┘ ┌───┼─╴ │ ┌─╴ │ ╷ └─┬─┴───┼───┐ └─┐ │ ┌─┘ │ ╷ ╵ ╶─┤ │ 
├───╴ │ ┌─┴─╴ │ │ └─┐ └─┬─┐ │ ╶─┴─┬─╴ │ ╶─┤ │ │ ╶─┘ ┌─────┤ ├───┘ ╷ └───┘ ┌─┘ ╷ ╷ └─┐ │ ┌─┐ ╵ ┌─┤ └─┐ ╷ │ ╶─┐ ╵ ┌───╴ │ │ │ │ └─┬─────┤ ╶─┴───┬─┘ ╷ ╵ ┌─┤ │ ╶─┤ ├─┐ ╵ ┌─┐ │ ╷ └─╴ │ └─┘ ╷ ├─┴─┬─╴ │ │ 
│ ╶─┬─┤ ╵ ┌───┘ └─┐ ├─╴ │ │ └─┐ ╷ │ ╶─┼───┤ │ └───┬─┴─╴ ╷ │ ╵ ╶─┐ └───┬───┼───┘ ├─╴ │ │ │ └───┤ ├─╴ │ │ └─┐ └─┬─┤ ╶─┐ │ │ │ └─┐ │ ╷ ╷ ├───┬─╴ │ ╶─┼───┘ │ ├─┐ │ │ └───┤ │ │ ├─────┴─╴ ┌─┴─┘ ╷ └─┐ │ │ 
│ ╷ │ ├───┤ ┌─┐ ╶─┘ ╵ ┌─┘ └─┐ └─┘ ├─╴ │ ╷ ╵ ├───┐ │ ┌─┬─┘ │ ┌───┴───╴ │ ╷ │ ╶─┬─┤ ╶─┤ │ └─╴ ╷ ╵ │ ┌─┴─┘ ╷ ├─┐ ╵ ├─┐ └─┘ │ └───┤ ├─┘ │ │ ╷ │ ╶─┴─╴ │ ┌─╴ │ │ ╵ │ ╵ ┌─╴ │ │ ╵ │ ╶─┬─────┤ ╶───┼─╴ ├─┘ │ 
├─┘ │ ╵ ╷ │ ╵ └─┬───┬─┘ ┌───┼───╴ │ ┌─┘ ├───┴─┐ │ ╵ │ │ ┌─┴─┘ ┌───────┘ │ └─╴ │ ├─╴ │ └─────┼─╴ │ │ ╶─┬─┘ ╵ └─┐ ╵ └─┬───┴─┬─╴ │ ╵ ┌─┘ │ │ └─┬─────┘ │ ╶─┤ └───┴───┤ ╶─┘ └─┬─┴─╴ ├───╴ ├───┐ └─┐ ╵ ╷ │ 
│ ╶─┤ ┌─┤ └─┐ ┌─┘ ╷ │ ╶─┘ ╷ ╵ ╶─┬─┘ │ ╶─┘ ┌─╴ │ └───┘ │ ├─╴ ┌─┘ ┌─────┐ ├─────┤ ╵ ╶─┴─┬───┐ └───┤ └─┐ └─┐ ┌───┴───╴ ├─╴ ╷ │ ┌─┴───┘ ┌─┴─┴─┐ ╵ ╷ ┌─╴ ├───┼───┐ ╷ ╷ ├─────╴ │ ╶─┬─┘ ╶─┬─┘ ╷ └─┐ ├───┘ │ 
├─╴ │ ╵ └─┐ ╵ │ ┌─┤ │ ╶───┴─┬───┘ ┌─┴─────┤ ┌─┴─╴ ┌─┐ │ ╵ ┌─┴───┘ ┌─┐ ╵ │ ┌─┐ │ ┌─────┘ ╷ └─┬─╴ │ ╷ │ ╷ └─┘ ┌─────┬─┘ ╶─┴─┤ ╵ ┌─────┴─┐ ╷ └─┐ │ └─┬─┘ ╷ ╵ ╷ └─┘ │ │ ╶───┬─┴─╴ ├───╴ │ ┌─┼─╴ │ │ ╶───┤ 
│ ╶─┤ ┌───┤ ╶─┤ │ │ └─┬───┐ │ ┌───┘ ┌───┐ ╵ │ ╶───┤ │ └─┬─┴─╴ ┌───┘ └─┐ │ │ │ └─┤ ╶───┬─┴─┐ ╵ ┌─┘ │ │ ├─────┤ ╷ ╶─┘ ┌───╴ └───┼───╴ ╷ │ ├─╴ └─┴─╴ │ ╶─┴─┬─┴─┬─╴ ├─┴───┐ └───┐ │ ╶───┤ ╵ │ ╷ │ └─┬─┐ │ 
│ ╷ ├─┘ ╷ └─┐ │ │ └─┐ │ ╶─┘ │ └─╴ ┌─┴─╴ ├───┤ ╶─┐ │ └─┐ ╵ ┌───┤ ┌─╴ ┌─┘ │ │ └─┐ └─┬─╴ │ ╶─┴───┴───┘ │ │ ╶───┘ ├─────┤ ┌─┬───┐ │ ┌───┤ │ └───┬─┬─╴ ├─┬─╴ │ ╷ └─┬─┘ ┌─╴ ├───╴ │ │ ╶─┐ └─╴ │ │ ├─╴ │ │ │ 
├─┘ │ ┌─┴─┐ └─┤ ╵ ╷ │ │ ╶───┴─┬───┤ ╶───┘ ╷ └─╴ │ │ ┌─┴───┤ ╷ ╵ │ ╶─┤ ╶─┤ ├─╴ ├─╴ │ ╶─┴─┐ ╶─┬─┬─────┘ │ ╶─────┤ ┌─┐ ╵ │ ╵ ╷ │ ╵ │ ╷ │ └───┐ │ │ ┌─┘ │ ╶─┤ ├─╴ │ ┌─┤ ╶─┘ ┌───┤ └───┤ ┌───┘ │ │ ┌─┤ ╵ │ 
│ ╶─┤ ╵ ┌─┴─┐ └───┤ │ ├─┬───┐ │ ┌─┘ ┌───┬─┴───┬─┤ │ ╵ ┌─┐ ╵ ├───┴─┐ └─╴ │ │ ╶─┤ ┌─┴───┐ └─╴ │ │ ┌───┬─┴─────┐ │ │ └───┤ ┌─┤ └───┘ │ └───┐ ╵ │ ╵ │ ╷ ├─╴ │ │ ╶─┘ │ └─────┘ ╷ └───┐ └─┤ ┌───┤ │ │ │ ╶─┤ 
│ ╷ ├─╴ │ ╷ │ ╶─┐ ╵ │ │ ╵ ╷ ╵ ╵ │ ┌─┘ ╷ │ ┌─╴ ╵ │ └─┐ ╵ └───┴─┐ ╶─┴─────┤ └─┐ │ ╵ ┌─┐ └─────┘ ╵ │ ┌─┘ ┌───┐ ╵ │ │ ╷ ┌─┘ │ ├───╴ ┌─┴─╴ ┌─┴───┘ ┌─┘ ├─┘ ╷ │ └─┬─┬─┘ ╷ ╶─────┴───┐ ├─╴ │ │ ╷ └─┘ │ └─╴ │ 
│ │ ╵ ┌─┤ │ └───┴─┐ │ └───┴─┬─╴ │ │ ┌─┘ ╵ │ ┌─┬─┴─╴ ├─────┬─┐ │ ╷ ╶───┐ └─┐ │ ├───┘ └─────┬─────┘ │ ┌─┘ ╷ └─┬─┘ │ └─┘ ┌─┘ │ ╷ ┌─┴─┬───┤ ╶─┬───┴─╴ │ ╶─┴─┴─╴ │ │ ┌─┴─┬───────┐ └─┘ ┌─┘ │ ├───┐ ├───┐ │ 
│ ├───┘ │ └───┬─┐ └─┤ ┌───╴ │ ╶─┤ │ └─┬───┤ ╵ │ ╶─┬─┘ ┌─╴ │ ╵ ├─┴───╴ ├───┘ │ ╵ ┌───┬───┐ ╵ ╷ ┌───┘ └─╴ ├─╴ │ ╶─┤ ╶───┘ ┌─┘ ├─┘ ╷ │ ╷ └─╴ │ ╶─┐ ╶─┴───────┬─┘ │ └─┐ │ ╶───┐ └─┬───┴─╴ │ │ ╷ │ │ ╷ │ │ 
│ │ ┌─╴ └───┐ │ └─┐ │ │ ┌───┴─┐ │ └─╴ │ ╷ ╵ ┌─┴─┐ │ ╶─┤ ┌─┘ ╶─┘ ┌───╴ │ ┌───┴─┬─┘ ╷ ╵ ╷ │ ┌─┤ ╵ ┌───┬─╴ ├───┴─┐ └───┬───┘ ╷ │ ╶─┤ ╵ ├─────┼───┴─────╴ ┌───┘ ╷ └─╴ │ └───┐ │ ╶─┘ ╷ ┌───┤ ╵ │ └─┘ │ │ │ 
│ │ │ ╶─┬───┘ │ ╶─┘ ├─┘ │ ╶─┐ └─┴─────┤ ├─┬─┘ ╷ ╵ ├─┐ │ └───┬───┴───┬─┘ │ ╷ ╷ ╵ ┌─┴─┬─┘ │ ╵ ├───┘ ╷ │ ┌─┘ ┌─┐ └───╴ │ ╶─┬─┴─┴─┐ ├───┘ ╶─┐ │ ┌───┐ ┌───┤ ╶─┬─┴───┐ └─┐ ╷ ╵ └───┬─┤ ╵ ╷ ├───┼─────┘ │ │ 
│ │ └─┬─┘ ┌───┤ ╶───┘ ╷ ├─┐ └─┬─────┐ ╵ │ │ ╶─┴─┐ ╵ │ └───┐ │ ╶───┐ ╵ ┌─┴─┤ └───┤ ╷ │ ╶─┴─┐ │ ┌───┤ └─┘ ┌─┘ └───┬───┴─╴ │ ┌─┐ ╵ ├───┬─╴ │ │ ╵ ╷ └─┘ ╷ └─╴ │ ┌─┐ ├─┐ └─┴───┬─╴ ╵ └───┤ ╵ ╷ │ ┌─╴ ┌─┴─┤ 
│ └─╴ │ ╶─┤ ╷ └─────┬─┤ │ └─┐ └─┬─╴ ├───┤ └─┬─╴ ├───┴───┐ │ └───╴ ├─┬─┘ ╷ ├───┐ │ └─┴─┬─╴ ├─┘ │ ┌─┴─────┘ ┌───╴ │ ╷ ╶───┘ │ └───┘ ╷ ╵ ┌─┤ ├───┤ ╶─┬─┴───┬─┘ │ │ │ └─────┐ └───────┐ ├───┤ │ └─┬─┘ ╷ │ 
├───┐ └─┐ │ └─────┐ │ ╵ │ ╶─┴─┐ ╵ ╷ ╵ ╷ │ ╶─┤ ╶─┤ ╶───┐ ╵ ├─┬─────┘ │ ╷ │ ╵ ╷ │ └─┐ ╶─┘ ┌─┘ ┌─┘ ╵ ╶─┬─┬─╴ ├─────┤ ├─────┬─┴─┐ ╷ ┌─┴─┬─┘ │ ╵ ╷ └─┐ └─╴ ┌─┘ ┌─┘ │ │ ┌───┐ └─────┬─╴ ├─┘ ╷ ╵ └─┐ ╵ ┌─┘ │ 
│ ╷ ├─╴ │ └─────╴ │ └─┐ │ ┌─╴ ├───┴───┤ │ ╷ └─┐ └───┐ ├─┬─┘ ╵ ┌───┐ │ │ └─┬─┘ └─┐ ├───┐ └─╴ │ ┌───┐ │ │ ┌─┘ ┌─╴ │ │ ╷ ╷ │ ╷ └─┤ ╵ ╷ │ ╷ ├───┴─╴ ├─────┘ ┌─┤ ╷ ╵ ├─┘ ╷ │ ╶───┐ ╵ ╶─┘ ┌─┴─────┼───┤ ╷ │ 
├─┘ │ ┌─┴─┬─┬─────┴─╴ │ └─┘ ┌─┘ ┌─┐ ╶─┘ └─┴─╴ └─┐ ╶─┤ │ ╵ ┌───┘ ┌─┘ │ └─┐ ├───┐ │ ╵ ╷ ├─────┴─┘ ╷ │ ╵ │ │ ╶─┤ ┌─┘ ├─┘ │ │ ├─┐ │ ┌─┘ │ └─┤ ╶─┬───┘ ┌─────┤ │ ├───┘ ┌─┤ ├───┐ └─┬───┐ │ ╶─┬─┐ ╵ ╷ │ │ │ 
│ ┌─┘ ╵ ╷ ╵ │ ╶─┬─╴ ┌─┴─────┤ ┌─┘ └───┬───────┐ ├─╴ │ │ ╶─┘ ┌─┐ │ ┌─┴─╴ │ │ ╷ │ ├───┘ │ ╶─┐ ┌───┘ └─┐ │ └─┐ │ │ ╶─┘ ┌─┤ ╵ │ │ └─┤ ╶─┤ ╷ └─┐ ├─╴ ┌─┘ ╶─┐ ╵ │ │ ╶─┬─┘ │ ╵ ╷ │ ┌─┘ ╷ ├─┴─┐ │ └───┤ ╵ │ │ 
│ ╵ ╶─┬─┴───┤ ╷ └─┬─┘ ┌───┐ ╵ │ ┌───╴ │ ┌───┐ │ │ ╶─┤ ├───┬─┘ ╵ │ ╵ ┌───┤ ╵ │ │ ╵ ┌───┤ ┌─┘ ├─────┐ ├─┴─┐ │ │ └─────┤ └─┬─┘ └─┐ └─┐ │ └─┐ ╵ ╵ ┌─┘ ╶─┐ │ ┌─┘ │ ╷ │ ╶─┴───┤ │ │ ╶─┤ │ ╷ ╵ │ ╶─┐ └─┬─┘ │ 
├───┐ │ ┌─╴ └─┴─╴ │ ╶─┤ ╷ └───┘ │ ┌───┘ │ ╷ ╵ │ └─┐ │ ╵ ╷ └─┐ ╶─┴───┼─╴ └───┤ └─┬─┘ ╷ └─┤ ╶─┤ ╶─┐ │ ╵ ╷ │ ╵ └─┐ ╶───┘ ╷ │ ╷ ┌─┴─╴ │ └───┴─┬───┘ ┌─┬─┘ ├─┘ ┌─┘ │ │ ┌───┐ ╵ ├─┴─╴ │ │ └─┬─┴─┐ │ ╶─┤ ┌─┤ 
│ ╷ └─┘ ├─────────┴─╴ │ └─┬─────┤ │ ╶─┬─┤ ├───┤ ┌─┘ └─┬─┼─╴ ├─────╴ ╵ ╷ ┌───┴─╴ │ ┌─┴─╴ └─╴ │ ┌─┘ ├───┤ └───┬─┴───┬───┤ │ │ ╵ ┌───┴─┬───┐ └─┐ ┌─┘ │ ╶─┘ ┌─┴───┤ │ └─╴ └───┘ ┌───┘ ├─╴ │ ╷ ╵ ├─╴ │ │ │ 
│ ├─────┘ ┌───────────┼─╴ │ ╷ ┌─┘ ├─╴ │ │ └─┐ ╵ │ ╶─┐ ╵ │ ╶─┴─┬─────┐ ├─┘ ┌─────┘ ├───────┐ │ │ ┌─┘ ╷ └───┐ ╵ ┌─╴ │ ╷ │ │ └───┤ ╷ ╷ │ ╷ └─┐ │ └─╴ ├─────┼─╴ ╷ ╵ ├───┬───┬───┤ ┌───┤ ╶─┤ └───┤ ╶─┘ │ │ 
│ ╵ ┌─────┤ ┌───┬─╴ ╷ └─┐ ╵ ├─┘ ╷ │ ┌─┘ └─┐ └─┐ └─┐ └─┐ └─┬─┐ │ ╶─┐ └─┘ ┌─┘ ┌───╴ │ ╶───┐ └─┤ │ ├───┤ ╶─┐ ├───┘ ┌─┘ │ ╵ └───┐ ├─┘ │ ╵ ├─┐ │ ├───╴ │ ┌─╴ ╵ ┌─┴───┤ ╷ │ ╷ ╵ ╷ ╵ │ ┌─┘ ╷ ├───┐ └─┬───┘ │ 
│ ╶─┤ ╷ ╷ │ │ ╷ │ ╶─┴─┐ └─┐ │ ╶─┴─┤ └─┬─╴ └─┐ └───┤ ╷ └─┐ ╵ │ └─╴ ├─────┤ ╶─┴─┐ ┌─┴───┐ ├─┐ ╵ │ ╵ ╷ ├─╴ │ ╵ ┌───┴─╴ ├─────┐ │ ╵ ┌─┴───┘ │ ╵ │ ╶─┬─┘ ├───┐ │ ┌─┐ │ └─┤ ├───┼───┤ ╵ ╶─┤ │ ╶─┴─┐ │ ╶───┤ 
├─┐ ├─┘ │ │ │ │ │ ╶─┐ ├─┐ └─┴───╴ ├─╴ │ ╶───┴─┬─┐ └─┴─┐ └─┐ ├─────┤ ╷ ┌─┘ ┌─┐ │ └─╴ ╷ │ ╵ ├───┼───┘ │ ┌─┴─┐ └─┐ ┌───┘ ┌─╴ ├─┴───┤ ┌─┐ ╷ └───┼─╴ │ ╷ ╵ ╷ └─┤ ╵ │ │ ╷ │ └─┐ ╵ ╷ ╵ ┌─┬─┘ │ ╶─┐ ╵ │ ╶─┐ │ 
│ │ │ ┌─┤ ├─┘ │ └───┘ │ └───╴ ┌───┘ ┌─┴─┬─╴ ╷ ╵ └───┐ │ ╷ │ ╵ ┌─┐ │ │ │ ┌─┘ │ ├─┐ ┌─┴─┼─╴ │ ╶─┤ ╶─┐ ├─┘ ╷ ├─╴ ╵ │ ╶─┬─┘ ┌─┘ ╷ ╶─┘ ╵ │ ├───╴ │ ╶─┤ ├───┼─┐ └─┐ │ ├─┘ ├─╴ │ ┌─┴─┐ ╵ │ ┌─┴─╴ └───┴───┤ │ 
│ ╵ │ │ │ ╵ ┌─┴───┐ ┌─┴─┬───┐ │ ┌─┬─┘ ╷ ╵ ┌─┴───╴ ┌─┘ │ │ ├─┬─┘ │ └─┤ │ ╵ ╷ │ │ ╵ │ ╷ ╵ ┌─┤ ╷ └─┐ └─┘ ┌─┤ └───┬─┘ ┌─┘ ┌─┘ ┌─┴───────┤ │ ╶─┬─┴─╴ │ ╵ ╷ ╵ ├─┐ ╵ │ │ ╷ │ ╶─┤ │ ╷ └───┘ ├───────┬───┐ │ │ 
│ ┌─┘ │ ╵ ┌─┘ ┌─╴ └─┘ ╷ ╵ ╷ └─┘ │ │ ╷ └───┼─────┐ │ ╶─┼─┘ │ ╵ ╷ └─┐ ╵ └─┬─┘ │ │ ┌─┘ ├───┘ ╵ │ ╶─┴─────┤ └───┐ │ ╶─┤ ╶─┘ ┌─┘ ┌─────┐ ╵ ├───┤ ┌───┴───┼─╴ ╵ └───┤ │ │ ├─╴ │ │ └───┬───┘ ┌─┬─╴ │ ╷ │ │ │ 
│ └─┐ ├───┘ ┌─┴───────┴─┬─┴───┬─┘ ╵ ├───┐ │ ┌─╴ │ ├─┐ ╵ ┌─┘ ╶─┤ ╶─┴─╴ ┌─┘ ┌─┤ └─┘ ┌─┴───┐ ╶─┴───┐ ╷ ┌─┘ ╷ ╶─┤ └─╴ └─┬───┤ ┌─┘ ┌─┐ ├───┘ ╷ │ └─┐ ╶─┐ │ ╶─┬─────┘ │ └─┘ ┌─┤ └───┐ ╵ ┌───┘ │ ┌─┴─┤ │ │ │ 
├─┐ ╵ │ ┌─╴ │ ┌───────┐ │ ╶─┐ │ ╶─┬─┘ ╷ │ │ │ ┌─┘ ╵ ├─╴ ├───┬─┴───────┤ ╶─┘ ├─────┘ ┌─┐ └─┬───┐ │ └─┘ ╶─┴─┐ ├───┬─╴ │ ╷ ╵ │ ┌─┘ │ ╵ ┌───┤ └─┐ └─┐ │ ├───┘ ┌───┬─┤ ┌───┘ └─┬─╴ ├───┤ ┌─╴ │ ╵ ╷ │ ╵ │ │ 
│ └─╴ │ └─┐ │ └───╴ ╷ │ │ ╷ └─┼─╴ ╵ ╷ ├─┘ │ │ └─────┘ ┌─┘ ╷ ╵ ┌─────┐ └───┐ └─┐ ┌───┤ └─╴ │ ╷ ╵ └─┬───┐ ┌─┘ │ ╷ │ ┌─┘ ├─╴ │ ├─╴ └─┬─┘ ╷ └─┐ └─┐ │ │ ╵ ┌───┘ ╷ │ │ └─┐ ╶───┤ ┌─┘ ╷ ╵ │ ╶─┴───┤ │ ┌─┘ │ 
│ ╶─┬─┴─╴ ├─┴───┬─╴ ├─┘ │ └─┐ ╵ ┌─┬─┴─┘ ╷ │ ├─────┬───┤ ╶─┼───┴─┐ ╷ └─┐ ╶─┼─╴ │ ╵ ╷ └─┐ ┌─┴─┴─────┘ ╷ └─┘ ┌─┘ │ └─┘ ╷ ├───┘ │ ╶─┐ ╵ ┌─┴───┤ ┌─┘ │ └─┬─┤ ╷ ╶─┤ ╵ ├─┐ │ ╶─┐ ╵ ╵ ┌─┴───┴─┬───┐ │ │ │ ╷ │ 
│ ┌─┘ ┌───┘ ╷ ╶─┘ ┌─┘ ┌─┴─╴ ├───┘ │ ┌───┴─┤ ├─╴ ╷ │ ╷ ├─┐ └─┐ ╷ └─┤ ╷ └─┐ │ ╶─┤ ╶─┴─┐ │ └─┐ ┌─┬─────┼───╴ │ ╶─┼─────┤ │ ╶─┬─┴─╴ ├─╴ │ ┌─╴ ╵ │ ┌─┴─╴ │ │ └─┐ └─┐ ╵ │ └───┴─────┤ ┌─┐ ╶─┘ ╷ ╵ │ │ ╵ │ │ 
├─┘ ┌─┘ ┌───┴───┬─┤ ┌─┤ ┌───┴───╴ │ │ ╶─┐ ╵ ╵ ┌─┤ │ │ ╵ ├─┐ │ └─┐ └─┤ ┌─┘ └─┐ │ ┌───┤ └─┐ ╵ │ ╵ ╷ ╶─┘ ┌───┤ ╷ │ ┌─╴ │ ├─╴ │ ╶─┐ ├───┘ ├───┬─┘ ├─╴ ┌─┘ └─╴ └─┐ └─┐ └───────┬─╴ │ │ └───┬─┴─┐ │ └─┬─┘ │ 
│ ╷ │ ┌─┘ ╷ ┌─╴ │ │ │ ╵ │ ╷ ╶─┬─╴ │ ╵ ┌─┴─────┤ ╵ │ ├─╴ ╵ │ │ ╷ ├─┐ ╵ │ ┌─╴ │ └─┘ ╷ └─┐ │ ┌─┴─┐ ├─────┘ ╷ └─┘ │ └───┘ │ ┌─┘ ╷ └─┤ ┌─╴ │ ╷ │ ╶─┤ ╷ ├─────┬─╴ ├─┐ └─────────┘ ┌─┤ ╵ ╷ ┌─┘ ╷ │ ├─┐ └─┐ │ 
│ └─┘ ├───┘ │ ┌─┘ │ └─┐ └─┴─╴ │ ╶─┴─┬─┘ ┌───┐ └─┐ ╵ ├───┬─┘ │ │ │ │ ┌─┘ │ ┌─┴─────┼─╴ │ └─┘ ╷ └─┤ ┌───┬─┴─────┘ ╶─┬───┤ └───┤ ╷ │ └───┤ │ ├─╴ │ ├─┘ ┌─╴ │ ┌─┘ ├───────┬─────┤ └───┘ │ ┌─┘ │ ╵ └─┐ └─┤ 
│ ┌───┤ ┌───┤ └─┐ └─┐ └─┬─────┘ ┌───┘ ┌─┴─┐ ├─╴ ├───┘ ╷ ╵ ┌─┴─┘ │ ╵ │ ╶─┼─┘ ╷ ╶───┘ ┌─┴───┬─┴─╴ │ │ ╶─┘ ╶───┬─────┤ ╷ └───┐ └─┤ ├───╴ │ │ ╵ ┌─┘ ╵ ┌─┘ ┌─┘ │ ╷ │ ╷ ┌─╴ │ ┌─┐ └─┐ ┌───┘ │ ╶─┴─┬───┴─┐ │ 
│ ╵ ╷ ╵ │ ╶─┴─╴ └─╴ └─┐ └───────┘ ╶───┘ ╷ ╵ │ ╶─┘ ╶───┴───┴─╴ ┌─┘ ╶─┴─┐ ╵ ╶─┴───────┘ ┌─╴ ╵ ┌─╴ │ └─────────┘ ╶─┐ ╵ │ ╶───┴─╴ ╵ │ ╶───┘ └───┴─────┘ ┌─┘ ╶─┘ │ └─┘ │ ╶─┘ │ └─╴ └─┘ ┌───┴───╴ ╵ ┌─╴ ╵ │ 
└───┴───┴─────────────┴─────────────────┴───┴─────────────────┴───────┴───────────────┴─────┴───┴───────────────┴───┴───────────┴───────────────────┴───────┴─────┴─────┴─────────┴───────────┴─────┘ 

